1 1    21 21
2 3    -5 21    -3 21    -1 21
3 3    1 21    3 21    5 21
4 2    -4 21    -2 21
5 2    2 21    4 21
6 3    21 -5    21 -3    21 -1
7 3    21 1    21 3    21 5
8 2    21 -4    21 -2
9 2    21 2    21 4
10 6    -5 2    -5 4    -3 2    -3 4    -1 2    -1 4
11 6    1 2    1 4    3 2    3 4    5 2    5 4
12 2    -4 4    -2 2
13 2    2 2    4 4
14 2    -4 2    -2 4
15 2    2 4    4 2
16 3    -5 5    -3 3    -1 1
17 3    1 1    3 3    5 5
18 6    -4 1    -4 3    -4 5    -2 1    -2 3    -2 5
19 6    2 1    2 3    2 5    4 1    4 3    4 5
20 6    -5 1    -5 3    -3 1    -3 5    -1 3    -1 5
21 6    1 3    1 5    3 1    3 5    5 1    5 3
22 6    -5 -4    -5 -2    -3 -4    -3 -2    -1 -4    -1 -2
23 6    1 -4    1 -2    3 -4    3 -2    5 -4    5 -2
24 2    -4 -4    -2 -2
25 2    2 -2    4 -4
26 2    -4 -2    -2 -4
27 2    2 -4    4 -2
28 3    -5 -5    -3 -3    -1 -1
29 3    1 -1    3 -3    5 -5
30 6    -4 -5    -4 -3    -4 -1    -2 -5    -2 -3    -2 -1
31 6    2 -5    2 -3    2 -1    4 -5    4 -3    4 -1
32 6    -5 -3    -5 -1    -3 -5    -3 -1    -1 -5    -1 -3
33 6    1 -5    1 -3    3 -5    3 -1    5 -3    5 -1
